[level]
map1 = 	1	7	13	19		
	2	8	14	20		
	3	9	15	21		
	4	10	16	22		
	5	11	17	23	
	6	12	18	24	
       


map2 = 	1	5	9	13	
	2	6	10	14	
	3	7	11	15	
	4	8	12	16	
       

map3 = 	1	5	9	9	9	13	9	9	9
	2	6	10	10	10	14	10	10	10
	3	7	11	11	11	15	11	11	11
	2	8	12	12	12	16	12	12	12
	2	2	2	2	2	2	2	2	2	
	2	2	2	2	2	2	2	2	2	
	2	2	2	2	2	2	2	2	2	
	4	4	16	4	4	4	12	12	12	
	4	4	4	4	4	12	12	12	12	
	4	4	4	4	4	4	4	4	4
       

map4 = 	2	2	2	2	2	2	2	2	2	2	
	2	2	2	2	2	2	2	2	2	2	
	2	2	2	2	2	2	2	2	2	2	
	11	11	11	11	11	11	11	11	11	11
	16	2	2	2	2	2	2	2	2	16	
	16	2	2	2	2	2	2	2	2	16
	16	2	2	2	2	2	2	2	2	16
	16	2	2	2	2	2	2	2	2	16
	16	2	2	2	2	2	2	2	2	16
	16	2	2	2	2	2	2	2	2	16
	16	2	2	2	2	2	2	2	2	16
	16	2	2	2	2	2	2	2	2	16
	16	2	2	2	2	2	2	2	2	16
	16	2	2	2	2	2	2	2	2	16
	16	2	2	2	2	2	2	2	2	16
	16	2	2	2	2	2	2	2	2	16
	16	2	2	2	2	2	2	2	2	16
	16	2	2	2	2	2	2	2	2	16
	16	2	2	2	2	2	2	2	2	16
	16	2	2	2	2	2	2	2	2	16
	16	2	2	2	2	2	2	2	2	16
	16	2	2	2	2	2	2	2	2	16
	16	2	2	2	2	2	2	2	2	16
	16	2	2	2	2	2	2	2	2	16
	16	2	2	2	2	2	2	2	2	16
	16	2	2	2	2	2	2	2	2	16
	16	2	2	2	2	2	2	2	2	16
	16	2	2	2	2	2	2	2	2	16
	16	16	16	16	16	16	16	16	16	16	

map5 = 	2	2	2	2	2	2	2	2	2	2	
	2	2	2	2	2	2	2	2	2	2	
	2	2	2	2	2	2	2	2	2	2	
	11	11	11	11	11	11	11	11	11	11
	16	4	8	12	2	10	12	8	4	16	
	16	4	8	12	2	10	12	8	4	16	
	16	4	8	12	2	10	12	8	4	16	
	16	4	8	12	2	10	12	8	4	16	
	16	4	8	12	2	10	12	8	4	16	
	16	4	8	12	2	10	12	8	4	16	
	16	4	8	12	2	10	12	8	4	16	
	16	4	8	12	2	10	12	8	4	16	
	16	4	8	12	2	10	12	8	4	16	
	16	4	8	12	2	10	12	8	4	16	
	16	4	8	12	2	10	12	8	4	16	
	16	4	8	12	2	10	12	8	4	16	
	16	4	8	12	2	10	12	8	4	16	
	16	4	8	12	2	10	12	8	4	16	
	16	4	8	12	2	10	12	8	4	16	
	16	4	8	12	2	10	12	8	4	16	
	16	4	8	12	2	10	12	8	4	16	
	16	4	8	12	2	10	12	8	4	16	
	16	4	8	12	2	10	12	8	4	16	
	16	4	8	12	2	10	12	8	4	16	
	16	4	8	12	2	10	12	8	4	16	
	16	4	8	12	2	10	12	8	4	16	
	16	4	8	12	2	10	12	8	4	16	
	16	4	8	12	2	10	12	8	4	16	
	16	16	16	16	2	10	16	16	16	16	

map6 = 	111	111	111	111	111	111	111	111	111	111	
	111	242	242	242	242	111	242	242	242	111	
	111	242	242	242	242	111	242	242	242	111	
	111	242	242	242	242	111	242	242	242	111	
	111	242	242	242	242	111	242	242	242	111	
	111	242	242	242	242	111	242	242	242	111	
	111	242	242	242	242	111	242	242	242	111	
	111	242	242	242	242	242	242	242	242	111	
	111	242	242	242	242	111	242	242	242	111	
	111	242	242	242	242	111	242	242	242	111	
	111	242	242	242	242	111	242	242	242	111	
	111	242	242	242	242	111	111	111	111	111	
	111	242	242	242	242	242	242	242	242	111	
	111	242	242	242	242	242	242	242	242	111	
	111	242	242	242	242	242	242	242	242	111	
	111	242	242	242	242	242	242	242	242	111	
	111	242	242	242	242	242	242	242	242	111	
	111	242	242	242	242	242	242	242	242	111	
	111	242	242	242	242	242	242	242	242	111	
	111	242	242	242	242	242	242	242	242	111	
	111	242	242	242	242	242	242	242	242	111	
	111	242	242	242	242	242	242	242	242	111	
	111	242	242	242	242	242	242	242	242	111	
	111	242	242	242	242	242	242	242	242	111	
	111	242	242	242	242	242	242	242	242	111	
	111	242	242	242	242	242	242	242	242	111	
	111	242	242	242	242	242	242	242	242	111	
	111	242	242	242	242	242	242	242	242	111	
	111	111	111	111	242	242	111	111	111	111	

map7 = 	16	4	4	4	4	4	4	4	4	16	
	16	4	4	4	4	4	4	4	4	16	
	16	4	4	4	4	4	4	4	4	16	
	16	4	4	4	4	4	4	4	4	16	
	16	16	16	16	16	16	16	16	16	16	
	16	4	4	4	4	4	4	4	4	16	
	16	4	4	4	4	4	4	4	4	16	
	16	4	4	4	4	4	4	4	4	16	
	16	4	4	4	4	4	4	4	4	16	
	16	4	4	4	4	4	4	4	4	16	
	16	4	4	4	4	4	4	4	4	16	
	16	4	4	4	4	4	4	4	4	16	
	16	4	4	4	4	4	4	4	4	16	
	16	4	4	4	4	4	4	4	4	16	
	16	4	4	4	4	4	4	4	4	16	
	16	4	4	4	4	4	4	4	4	16	
	16	4	4	4	4	4	4	4	4	16	
	16	4	4	4	4	4	4	4	4	16	
	16	4	4	4	4	4	4	4	4	16	
	16	4	4	4	4	4	4	4	4	16	
	16	4	4	4	4	4	4	4	4	16	
	16	4	4	4	4	4	4	4	4	16	
	16	4	4	4	4	4	4	4	4	16	
	16	4	4	4	4	4	4	4	4	16	
	16	4	4	4	4	4	4	4	4	16	
	16	4	4	4	4	4	4	4	4	16	
	16	4	4	4	4	4	4	4	4	16	
	16	4	4	4	4	4	4	4	4	16	
	16	16	16	16	4	4	16	16	16	16	
